NO ./textures/north.xpm
SO ./textures/south.xpm
WE ./textures/west.xpm
EA ./textures/east.xpm

F 88,88,88
C 135,206,235

111111111  1111111
100001001  1000001
100001001111000001
100001000000000011
100001011111111111
10000101        
10000001111111111
10000100000000001
10000100000000001
10000100000000001
11111110000000001
     100000000001
     100000000001111111
     110000100000000001
      10000000000000001
      10000001111000001
      10000100001111101
      10111100001   101
      10000100001111111
      100000001000000W1
      11111111111111111
